11111111111111111111111111111111111111111111111111111111111
1E0000000000000C00000C00000000000CCCCCCCCCCCCCCCCCC00000001
101001010010000010100100000001010CCCCCCCCCCCCCCCCCC00000001
101001001010101000100100000001010CCCCCCCCCCCCCCCCCC00000001
1P0000000C00CCCCCCCCCCCCCCCCCCCCCCCCCCCCCCCCCCCCCCC00000001
101001001010101000100100000001010CCCCCCCCCCCCCCCCCC00000001
10100100101010100010010000000C010CCCCCCCCCCCCCCCCCC00000001
10100C001010101000100100000001010CCCCCCCCCCCCCCCCCC00000001
1010010010101010001001000C0001010CCCCCCCCCCCCCCCCCC00000001
10100100101010100010010000000C0C0CCCCCCCCCCCCCCCCCC00000001
101001001010101000100100000001010CCCCCCCCCCCCCCCCCC00000001
1010010010C0101000100100C000010C0CCCCCCCCCCCCCCCCCC00000001
101001001010101000100100000001010CCCCCCCCCCCCCCCCCC00000001
1100111111111111111111111111111111111111CCCCCCCCCCC00000001
1100111111111111111111111111111111111111CCCCCCCCCCC00000001
100000000000000C00000C00000000000CCCCCCCCCCCCCCCCCC00000001
101001010010000010100100000001010CCCCCCCCCCCCCCCCCC00000001
101001001010101000100100000001010CCCCCCCCCCCCCCCCCC00000001
100000000C00CCCCCCCCCCCCCCCCCCCCCCCCCCCCCCCCCCCCCCC00000001
101001001010101000100100000001010CCCCCCCCCCCCCCCCCC00000001
10100100101010100010010000000C010CCCCCCCCCCCCCCCCCC00000001
11111111111111111111111111111111111111111111111111111111111
