111111
1P0101
100001
1C0E01
11111q
